abadejo	abadej
abocado	aboc
aborrajado	aborraj
aceite	aceit
aceituna	aceitun
acelga	acelg
achicoria	achicori
achiote	achiot
achira	achir
aderezo	aderez
aditamento	aditament
adobada	adob
adobo	adob
agua	agu
aguacate	aguacat
aguadepanela	aguadepanel
aguapanela	aguapanel
aguardiente	aguardient
ahumada	ahum
ahumado	ahum
aji	aji
ajiaco	ajiac
ajo	ajo
ajonjoli	ajonjoli
albahaca	albahac
albaricoque	albaricoqu
albondiga	albondig
alcachofa	alcachof
alcaparra	alcaparr
alcapurria	alcapurri
alfajor	alfajor
alimento	aliment
aliño	aliñ
allulla	allull
almeja	almej
almendra	almendr
almibar	almib
almidon	almidon
almojabana	almojaban
almuerzo	almuerz
alubia	alubi
anchoa	ancho
anis	anis
anticucho	anticuch
aperitif	aperitif
aperitivo	aperit
apetito	apetit
apfelstrudel	apfelstrudel
apio	api
arancini	arancini
arandano	arandan
arenque	arenqu
arepa	arep
arequipe	arequip
aromatica	aromat
arrayan	array
arroces	arroc
arroz	arroz
arugula	arugul
arveja	arvej
asada	asad
asadero	asader
asadito	asadit
asado	asad
asadura	asadur
asarlo	asarl
asopao	asopa
atol	atol
atole	atol
atollabuey	atollabuey
atun	atun
avellana	avellan
avena	aven
ayote	ayot
azafran	azafr
azucar	azuc
bacalaito	bacalait
bacalao	bacala
bacardi	bacardi
bacon	bacon
bagels	bagels
bagnat	bagnat
baguete	baguet
baguette	baguett
baileys	baileys
bailey's	bailey's
ballantine's	ballantine's
banana	banan
banano	banan
banku	banku
banrock	banrock
baozi	baozi
bapao	bapa
bara	bar
barbacoa	barbaco
barquillo	barquill
basmati	basmati
batata	batat
batido	bat
bauernfr	bauernfr
baya	bay
bazlama	bazlam
beans	beans
bebida	beb
bechamel	bechamel
beer	beer
beguni	beguni
beignet	beignet
beondegi	beondegi
berenjena	berenjen
berlinesa	berlines
berro	berr
bescheutti	bescheutti
beurre	beurr
bhaji	bhaji
bhelpuri	bhelpuri
bhurji	bhurji
bienmesabe	bienmesab
bigilla	bigill
biscotti	biscotti
biscuit	biscuit
biste	bist
bistec	bistec
bitters	bitters
bizcochito	bizcochit
bizcocho	bizcoch
bizcochuelo	bizcochuel
bleo	ble
blini	blini
blinis	blinis
bocachico	bocach
bocadillo	bocadill
bocadito	bocadit
boerewors	boerewors
boliño	boliñ
bollo	boll
bolognesa	bolognes
bolonesa	bolones
boloñesa	boloñes
boniato	boniat
boronia	boroni
botana	botan
brandy	brandy
bratwurst	bratwurst
bread	bre
breakfast	breakfast
bretaña	bretañ
brevas	brev
brioche	brioch
broaster	broast
broccoflower	broccoflow
brocheta	brochet
brocoli	brocoli
brotzeit	brotzeit
brunch	brunch
budare	budar
budin	budin
bufe	buf
bufet	bufet
bungeoppang	bungeoppang
bunuelo	bunuel
buñuelo	buñuel
burasa	buras
burek	burek
butifarra	butifarr
caballa	caball
cabra	cabr
cabrito	cabrit
cacahuate	cacahuat
cacahuete	cacahuet
cacao	caca
cachapa	cachap
cafe	caf
cake	cak
calabacin	calabacin
calabaza	calabaz
calabazo	calabaz
calamar	calam
calamares	calamar
caldo	cald
calducho	calduch
calentado	calent
calentao	calenta
camaron	cam
camarones	camaron
camembert	camembert
camote	camot
campari	campari
canela	canel
canelon	canelon
canjica	canjic
canonigos	canonig
cantimpalo	cantimpal
cappuccino	cappuccin
capuchino	capuchin
caramañola	caramañol
caramelo	caramel
caraotas	caraot
carantanta	carantant
cargamanto	cargamant
carimañola	carimañol
carne	carn
carnita	carnit
caruru	caruru
casabe	casab
cassata	cassat
cassis	cassis
cassoulet	cassoulet
catibias	catibi
caupi	caupi
cayeye	cayey
cazuela	cazuel
cebada	ceb
cebolla	ceboll
cebolleta	cebollet
cebollin	cebollin
cebollino	cebollin
cena	cen
centeno	centen
cerdo	cerd
cereal	cereal
cereza	cerez
cerveza	cervez
ceviche	cevich
chaap	chaap
chaat	chaat
chacarero	chacarer
chadon	chadon
chai	chai
chakkuli	chakkuli
chalote	chalot
champagne	champagn
champan	champ
champana	champan
champaña	champañ
champinon	champinon
champiñon	champiñon
champus	champus
chanachur	chanachur
chancaca	chancac
changua	changu
channa	chann
chaparrita	chaparrit
chaucha	chauch
chebureki	chebureki
cheesecake	cheesecak
chholey	chholey
chicha	chich
chicharron	chicharron
chicharronada	chicharron
chicle	chicl
chikuwa	chikuw
chilaquiles	chilaquil
chili	chili
chiltepes	chiltep
chimichurri	chimichurri
chinchurria	chinchurri
chip	chip
chipotle	chipotl
chips	chips
chiverre	chiverr
chivo	chiv
choclo	chocl
choclotanda	choclotand
chocolate	chocolat
chocolatina	chocolatin
chocolatin	chocolatin
chocolatines	chocolatin
choncholies	choncholi
choricillo	choricill
choripan	chorip
choripanes	choripan
chorizo	choriz
choux	choux
chucrut	chucrut
chuleta	chulet
chuño	chuñ
chupe	chup
chupichupi	chupichupi
churrasco	churrasc
churro	churr
churumuri	churumuri
chutney	chutney
chutneys	chutneys
cidra	cidr
ciganska	cigansk
cilantro	cilantr
cinzano	cinzan
ciruela	ciruel
clavo	clav
clicquot	clicquot
coalho	coalh
cocacola	cocacol
coca-cola	coca-col
cocada	coc
coco	coc
cocoa	coco
coctel	coctel
codornices	codornic
codorniz	codorniz
coñac	coñac
cointreau	cointreau
colacion	colacion
coliflor	coliflor
comida	com
comino	comin
compango	compang
compota	compot
conacs	conacs
concassee	concasse
condimento	condiment
conserva	conserv
consome	consom
cordero	corder
corozo	coroz
costilla	costill
cotoletta	cotolett
coulis	coulis
courvoisier	courvoisi
crema	crem
creme	crem
crepe	crep
crespells	crespells
criadillas	criadill
croissant	croissant
croissants	croissants
croqueta	croquet
cruasan	cruas
cuajada	cuaj
cuajadita	cuajadit
cup-cake	cup-cak
curcuma	curcum
curri	curri
curry	curry
currywurst	currywurst
cutty	cutty
cuy	cuy
cynar	cynar
dabeli	dabeli
dahi	dahi
dahl	dahl
damasco	damasc
datil	datil
delicatesen	delicates
desayuno	desayun
dewars	dewars
dona	don
donut	donut
donuts	donuts
dosais	dosais
dulce	dulc
dumpling	dumpling
dumplings	dumplings
durazno	durazn
eclair	ecla
elote	elot
embutido	embut
embutir	embut
empanada	empan
empanadilla	empanadill
empanadita	empanadit
empanizao	empaniza
emparedado	empared
encurtido	encurt
enlatado	enlat
ensalada	ensal
entresijo	entresij
envuelto	envuelt
enyucado	enyuc
eristoff	eristoff
escabeche	escabech
escalope	escalop
escarola	escarol
espagueti	espagueti
espaguetis	espaguetis
espaguetti	espaguetti
esparrago	esparrag
espinaca	espinac
estofado	estof
estragon	estragon
falafel	falafel
falafels	falafels
fecula	fecul
fernet	fernet
feuillatte	feuillatt
fiambre	fiambr
fideo	fide
filet	filet
filete	filet
fish	fish
fishcake	fishcak
flan	flan
focaccia	focacci
frambuesa	frambues
frejol	frejol
fresa	fres
frijol	frijol
frikandellen	frikandell
frisuelo	frisuel
fritanga	fritang
frito	frit
fritura	fritur
fromage	fromag
fruta	frut
frutilla	frutill
fufu	fufu
fugazzeta	fugazzet
funche	funch
gacha	gach
galgueria	galgueri
galleta	gallet
galletita	galletit
gamba	gamb
gandules	gandul
ganso	gans
garbanzo	garbanz
gaseosa	gaseos
gaseosas	gase
gelatina	gelatin
gimbap	gimbap
ginebra	ginebr
girasol	girasol
glenfiddich	glenfiddich
glenlivet	glenlivet
gofio	gofi
gofre	gofr
golosina	golosin
gouda	goud
granadilla	granadill
granola	granol
grants	grants
gravy	gravy
grille	grill
griot	griot
grosella	grosell
guacamole	guacamol
guayaba	guay
guayoyo	guayoy
guinda	guind
guindilla	guindill
guineos	guine
guisado	guis
guisante	guisant
gyros	gyros
haba	hab
habichuela	habichuel
hallaca	hallac
hallaquita	hallaquit
hallullas	hallull
halumi	halumi
hamburguesa	hamburgues
harina	harin
harzer	harz
haytalya	haytaly
hbejza	hbejz
heidsieck	heidsieck
heineken	heinek
helado	hel
hennessy	hennessy
hierba	hierb
hierbabuena	hierbabuen
higado	hig
higo	hig
hinojo	hinoj
hogao	hoga
hogo	hog
hojaldre	hojaldr
hojuela	hojuel
hoppin	hoppin
hortaliza	hortaliz
hotteok	hotteok
htamin	htamin
hummus	hummus
ibia	ibi
idli	idli
imagawayaki	imagawayaki
imqaret	imqaret
infusion	infusion
irkotta	irkott
islak	islak
itatitaia	itatitai
jaegermeister	jaegermeist
jaggery	jaggery
jalapeno	jalapen
jalapeño	jalapeñ
jalea	jale
jamon	jamon
jengibre	jengibr
jericalla	jericall
jhal	jhal
jijas	jij
jitomate	jitomat
johnnycake	johnnycak
jojoto	jojot
jonnycake	jonnycak
jugo	jug
kaassouffle	kaassouffl
kacang	kacang
kaffee	kaffe
kaki	kaki
kakoiyael	kakoiyael
kalacs	kalacs
kalamay	kalamay
karamanducas	karamanduc
karamanduka	karamanduk
kebab	kebab
kebabs	kebabs
kebap	kebap
kechup	kechup
kellogg	kellogg
kenkey	kenkey
ketchup	ketchup
ketel	ketel
kiwi	kiwi
koskera	kosker
kumala	kumal
lacteo	lacte
lahmacun	lahmacun
lait	lait
lanche	lanch
langosta	langost
langostin	langostin
langostino	langostin
lasana	lasan
lasaña	lasañ
latte	latt
laurel	laurel
leberk	leberk
leberwurst	leberwurst
leche	lech
lechera	lecher
lechona	lechon
lechuga	lechug
legumbre	legumbr
leite	leit
lemang	lemang
lengua	lengu
lenguado	lengu
lenteja	lentej
levadura	levadur
licor	licor
lima	lim
limon	limon
limonada	limon
linaza	linaz
lindemans	lindemans
liwet	liwet
llajwa	llajw
llapingachos	llapingach
llardons	llardons
llushtu	llushtu
lokma	lokm
lomillo	lomill
lomito	lomit
lomo	lom
loncha	lonch
longanicilla	longanicill
longaniza	longaniz
lucuma	lucum
lulo	lul
lunch	lunch
lunumiris	lunumiris
lupulo	lupul
macallan	macall
macarron	macarron
macchiato	macchiat
macdonald	macdonald
machica	machic
machuquillo	machuquill
mahonesa	mahones
maicena	maicen
maiz	maiz
maizena	maizen
malta	malt
malteada	malt
mandarina	mandarin
mandioca	mandioc
mandoca	mandoc
mango	mang
mani	mani
manjar	manj
manteca	mantec
mantecada	mantec
mantecado	mantec
mantequilla	mantequill
manzana	manzan
manzanilla	manzanill
maracuya	maracu
margarina	margarin
margarita	margarit
marisco	marisc
marmoleado	marmol
marnier	marni
marranita	marranit
marrano	marran
martell	martell
martini	martini
masala	masal
masato	masat
mate	mat
mayonesa	mayones
mazamorra	mazamorr
mazapan	mazap
mazorca	mazorc
mecato	mecat
mejillon	mejillon
melao	mela
melaza	melaz
melocoton	melocoton
melon	melon
membrillo	membrill
menudencia	menudent
merengon	merengon
merengue	mereng
merienda	meriend
mermelada	mermel
mero	mer
mezcolanza	mezcol
mezze	mezz
miel	miel
miga	mig
milanesa	milanes
milhoja	milhoj
mirepoix	mirepoix
mofongo	mofong
mole	mol
moleque	molequ
mollete	mollet
mondongo	mondong
mora	mor
morcilla	morcill
morcipan	morcip
morron	morron
mortadela	mortadel
moskowskaya	moskowskay
mostaza	mostaz
mote	mot
motuleño	motuleñ
mousse	mouss
mozarella	mozarell
mozzarella	mozzarell
muchines	muchin
muday	muday
muesli	muesli
musli	musli
multivitaminico	multivitamin
murta	murt
naans	naans
nabicol	nabicol
nabo	nab
nachos	nach
nance	nanc
naranja	naranj
naranjada	naranj
nata	nat
natilla	natill
nectar	nect
nectares	nectar
noquis	noquis
nueces	nuec
nuez	nuez
nugget	nugget
nutella	nutell
ñame	ñam
oblea	oble
obwarzanki	obwarzanki
odeng	odeng
oliebol	oliebol
oliva	oliv
oregano	oregan
osso-bucco	osso-bucc
osobuco	osobuc
ostra	ostra
ostras	ostras
oushe	oush
paella	paell
padoka	padok
paleta	palet
palta	palt
pambazas	pambaz
pamoña	pamoñ
pan	pan
panapen	panap
pancakes	pancak
panceta	pancet
pandebono	pandebon
pandequeso	pandeques
pandeyuca	pandeyuc
panecillo	panecill
panela	panel
panelon	panelon
panetela	panetel
panini	panini
panqueque	panquequ
papaya	papay
papilla	papill
papitas	papit
paprika	paprik
paprikawurst	paprikawurst
parrilla	parrill
pasaboca	pasaboc
pasas	pas
pasta	past
pastel	pastel
pastelillo	pastelill
pastelito	pastelit
pasteurizada	pasteuriz
pastis	pastis
pastizzi	pastizzi
patacon	patacon
patat	patat
patata	patat
pate	pat
pavo	pav
paxamadion	paxamadion
pechuga	pechug
pelanga	pelang
pepinillo	pepinill
pepino	pepin
pepsi	pepsi
pera	per
perejil	perejil
perignon	perignon
pernil	pernil
pernod	pernod
peroni	peroni
perro	perr
pescado	pesc
peto	pet
picada	pic
picadillo	picadill
picante	picant
picnic	picnic
pilsen	pils
pimenton	pimenton
pimienta	pimient
pimiento	pimient
pincho	pinch
piña	piñ
piñita	piñit
pionono	pionon
pipers	pipers
pisco	pisc
pistacho	pistach
pita	pit
pitahaya	pitahay
pitaya	pitay
pizza	pizz
platano	platan
platija	platij
platillo	platill
pochoclo	pochocl
pollo	poll
pomelo	pomel
ponque	ponqu
poroto	porot
porotta	porott
porridge	porridg
postre	postr
potaje	potaj
pretzel	pretzel
proteina	protein
pudin	pudin
puerro	puerr
pulpa	pulp
pulpo	pulp
pure	pur
quesada	ques
quesadilla	quesadill
quesillo	quesill
queso	ques
quiche	quich
quinoa	quino
rabano	raban
ravioles	raviol
ravioli	ravioli
redbull	redbull
refresco	refresc
refrigerio	refrigeri
refrito	refrit
regaliz	regaliz
rellena	rellen
remolacha	remolach
repollo	repoll
requeson	requeson
requezon	requezon
res	res
rice	ric
rollito	rollit
rollo	roll
romero	romer
ron	ron
rosbif	rosbif
roastbeef	roastbeef
rosquilla	rosquill
rosticcerie	rosticceri
rotisserie	rotisseri
ruibarbo	ruibarb
rucula	rucul
rugula	rugul
sal	sal
salame	salam
salami	salami
salchicha	salchich
salchichon	salchichon
salchipapa	salchipap
salmon	salmon
salpicon	salpicon
salsa	sals
salvado	salv
salvia	salvi
sancocho	sancoch
sandia	sandi
sanduche	sanduch
sandwich	sandwich
sardina	sardin
sardinilla	sardinill
seagram's	seagram's
semilla	semill
semola	semol
seta	set
shiitake	shiitak
sidra	sidr
smirnoff	smirnoff
snack	snack
snickers	snickers
soda	sod
soja	soj
sopa	sop
sorbete	sorbet
soya	soy
spaghetti	spaghetti
spaghettis	spaghettis
sparkling	sparkling
spritzer	spritz
steak	steak
stolichnaya	stolichnay
sushi	sushi
sushki	sushki
sutter	sutt
taco	tac
taittinger	taitting
taiyaki	taiyaki
tajadita	tajadit
tallarin	tallarin
tamal	tamal
tarta	tart
tartara	tart
tequila	tequil
ternera	terner
tilapia	tilapi
tilsit	tilsit
tinto	tint
tiramisu	tiramisu
tisanas	tisan
toblerone	tobleron
tocino	tocin
tofu	tofu
tomate	tomat
tomillo	tomill
toronja	toronj
torreja	torrej
torta	tort
tortilla	tortill
tostada	tost
tostado	tost
trago	trag
trigo	trig
trucha	truch
trufa	truf
tuberculo	tubercul
turron	turron
twix	twix
uva	uva
uvas	uvas
vainilla	vainill
vanilla	vanill
vegetal	vegetal
velout	velout
verdura	verdur
vermouth	vermouth
vinagre	vinagr
vinagreta	vinagret
vino	vin
vodka	vodk
volovan	volov
whiskey	whiskey
whisky	whisky
willkaparu	willkaparu
yaniqueques	yaniquequ
yeast	yeast
yema	yem
yerbabuena	yerbabuen
yogur	yogur
yogurt	yogurt
yuca	yuc
zabaione	zabaion
zacapa	zacap
zanahoria	zanahori
zancarron	zancarron
zapiekanki	zapiekanki
zarajo	zaraj
zarangollo	zarangoll
zarzamora	zarzamor
zongzi	zongzi
zumo	zum
