abadejo	NOUN__Gender=Masc|Number=Sing	NOUN
abocado	ADJ__Gender=Masc|Number=Sing|VerbForm=Part	ADJ
aborrajado	ADJ__Gender=Masc|Number=Sing|VerbForm=Part	ADJ
aceite	NOUN__Gender=Masc|Number=Sing	NOUN
aceituna	NOUN__Gender=Fem|Number=Sing	NOUN
acelga	NOUN__Gender=Fem|Number=Sing	NOUN
achicoria	NOUN__Gender=Fem|Number=Sing	NOUN
achiote	NOUN__Gender=Masc|Number=Sing	NOUN
achira	VERB__Mood=Ind|Number=Sing|Person=3|Tense=Pres|VerbForm=Fin	VERB
aderezo	NOUN__Gender=Masc|Number=Sing	NOUN
aditamento	NOUN__Gender=Masc|Number=Sing	NOUN
adobada	ADJ__Gender=Fem|Number=Sing|VerbForm=Part	ADJ
adobo	NOUN__Gender=Masc|Number=Sing	NOUN
agua	NOUN__Gender=Fem|Number=Sing	NOUN
aguacate	NOUN__Gender=Masc|Number=Sing	NOUN
aguadepanela	VERB__Mood=Ind|Number=Sing|Person=3|Tense=Pres|VerbForm=Fin	VERB
aguapanela	VERB__Mood=Ind|Number=Sing|Person=3|Tense=Pres|VerbForm=Fin	VERB
aguardiente	NOUN__Gender=Masc|Number=Sing	NOUN
ahumada	ADJ__Gender=Fem|Number=Sing|VerbForm=Part	ADJ
ahumado	ADJ__Gender=Masc|Number=Sing|VerbForm=Part	ADJ
aji	ADV___	ADV
ajiaco	NOUN__Gender=Masc|Number=Sing	NOUN
ajo	NOUN__Gender=Masc|Number=Sing	NOUN
ajonjoli	ADV___	ADV
akara	VERB__Mood=Sub|Number=Sing|Person=3|Tense=Imp|VerbForm=Fin	VERB
albahaca	NOUN__Gender=Fem|Number=Sing	NOUN
albaricoque	NOUN__Gender=Masc|Number=Sing	NOUN
albondiga	VERB__Mood=Sub|Number=Sing|Person=3|Tense=Pres|VerbForm=Fin	VERB
alcachofa	NOUN__Gender=Fem|Number=Sing	NOUN
alcaparra	NOUN__Gender=Fem|Number=Sing	NOUN
alcapurria	ADJ__Gender=Fem|Number=Sing	ADJ
alfajor	NOUN__Gender=Masc|Number=Sing	NOUN
alimento	NOUN__Gender=Masc|Number=Sing	NOUN
aliño	NOUN__Gender=Masc|Number=Sing	NOUN
allulla	VERB__Mood=Ind|Number=Sing|Person=3|Tense=Pres|VerbForm=Fin	VERB
almeja	NOUN__Gender=Fem|Number=Sing	NOUN
almendra	NOUN__Gender=Fem|Number=Sing	NOUN
almibar	VERB__VerbForm=Inf	VERB
almidon	NOUN__Gender=Masc|Number=Sing	NOUN
almojabana	NOUN__Gender=Fem|Number=Sing	NOUN
almuerzo	NOUN__Gender=Masc|Number=Sing	NOUN
alubia	NOUN__Gender=Fem|Number=Sing	NOUN
anchoa	NOUN__Gender=Fem|Number=Sing	NOUN
anis	ADV___	ADV
anticucho	ADJ__Gender=Masc|Number=Sing|VerbForm=Part	ADJ
aperitif	ADV___	ADV
aperitivo	NOUN__Gender=Masc|Number=Sing	NOUN
apetito	NOUN__Gender=Masc|Number=Sing	NOUN
apfelstrudel	ADV___	ADV
apio	NOUN__Gender=Masc|Number=Sing	NOUN
arancini	NOUN__Gender=Masc|Number=Plur	NOUN
arandano	NOUN__Gender=Masc|Number=Sing	NOUN
arenque	NOUN__Gender=Masc|Number=Sing	NOUN
arepa	NOUN__Gender=Fem|Number=Sing	NOUN
arequipe	NOUN__Gender=Masc|Number=Sing	NOUN
aromatica	ADJ__Gender=Fem|Number=Sing	ADJ
arrayan	ADV___	ADV
arroces	NOUN__Gender=Masc|Number=Plur	NOUN
arroz	NOUN__Gender=Masc|Number=Sing	NOUN
arugula	VERB__Mood=Ind|Number=Sing|Person=3|Tense=Pres|VerbForm=Fin	VERB
arveja	NOUN__Gender=Fem|Number=Sing	NOUN
asada	ADJ__Gender=Fem|Number=Sing|VerbForm=Part	ADJ
asadero	NOUN__Gender=Masc|Number=Sing	NOUN
asadito	NOUN__Gender=Masc|Number=Sing	NOUN
asado	ADJ__Gender=Masc|Number=Sing|VerbForm=Part	ADJ
asadura	NOUN__Gender=Fem|Number=Sing	NOUN
asarlo	VERB__VerbForm=Inf	VERB
asopao	NOUN__Gender=Masc|Number=Sing	NOUN
atol	NOUN__Gender=Masc|Number=Sing	NOUN
atollabuey	ADV___	ADV
atun	NOUN__Gender=Fem|Number=Sing	NOUN
avellana	NOUN__Gender=Fem|Number=Sing	NOUN
avena	NOUN__Gender=Fem|Number=Sing	NOUN
ayote	NOUN__Gender=Masc|Number=Sing	NOUN
azafran	VERB__Mood=Sub|Number=Plur|Person=3|Tense=Imp|VerbForm=Fin	VERB
azucar	NOUN__Gender=Masc|Number=Sing	NOUN
bacalaito	ADJ__Gender=Masc|Number=Sing|VerbForm=Part	ADJ
bacalao	NOUN__Gender=Masc|Number=Sing	NOUN
bacardi	NOUN__Gender=Masc|Number=Sing	NOUN
bacon	NOUN__Gender=Masc	NOUN
bagels	ADJ__Gender=Fem|Number=Plur	ADJ
bagnat	NOUN__Gender=Masc|Number=Plur	NOUN
baguete	ADJ__Gender=Masc|Number=Sing	ADJ
baguette	ADJ__Number=Sing	ADJ
baileys	NOUN__Gender=Masc|Number=Plur	NOUN
bailey	ADJ__Gender=Masc|Number=Sing	ADJ
's	PROPN___	PROPN
bake	NOUN__Gender=Masc|Number=Plur	NOUN
baked	NOUN__Gender=Masc|Number=Sing	NOUN
ballantine	NOUN__Gender=Masc|Number=Sing	NOUN
's	PROPN___	PROPN
banana	NOUN__Gender=Fem|Number=Sing	NOUN
banano	NOUN__Gender=Masc|Number=Sing	NOUN
banku	NOUN__Gender=Masc|Number=Plur	NOUN
banrock	NOUN___	NOUN
baozi	NOUN__Gender=Masc|Number=Plur	NOUN
bapao	NOUN__Gender=Masc|Number=Plur	NOUN
bara	VERB__Mood=Sub|Number=Sing|Person=3|Tense=Imp|VerbForm=Fin	VERB
barbacoa	NOUN__Gender=Fem|Number=Sing	NOUN
barquillo	NOUN__Gender=Masc|Number=Sing	NOUN
basmati	ADJ__Gender=Masc|Number=Sing	ADJ
batata	NOUN__Gender=Fem|Number=Sing	NOUN
batido	ADJ__Gender=Masc|Number=Sing|VerbForm=Part	ADJ
bauernfr	NOUN__Gender=Masc|Number=Plur	NOUN
baya	NOUN__Gender=Fem|Number=Sing	NOUN
bazlama	NOUN__Gender=Masc|Number=Sing	NOUN
beans	NOUN___	NOUN
bebida	NOUN__Gender=Fem|Number=Sing	NOUN
bechamel	NOUN__Gender=Fem|Number=Sing	NOUN
beer	NOUN___	NOUN
beguni	NOUN__Gender=Masc|Number=Plur	NOUN
beignet	NOUN___	NOUN
beondegi	NOUN__Gender=Masc|Number=Plur	NOUN
berenjena	NOUN__Gender=Fem|Number=Sing	NOUN
berlinesa	ADJ__Gender=Fem|Number=Sing	ADJ
berro	NOUN__Gender=Masc|Number=Sing	NOUN
bescheutti	NOUN__Gender=Masc|Number=Plur	NOUN
beurre	VERB__Mood=Ind|Number=Sing|Person=3|Tense=Pres|VerbForm=Fin	VERB
bhaji	NOUN__Gender=Masc|Number=Plur	NOUN
bhelpuri	NOUN__Gender=Masc|Number=Plur	NOUN
bhurji	NOUN__Gender=Masc|Number=Plur	NOUN
bienmesabe	NOUN__Gender=Fem|Number=Sing	NOUN
bigilla	VERB__Mood=Ind|Number=Sing|Person=3|Tense=Pres|VerbForm=Fin	VERB
biscotti	NOUN__Gender=Masc|Number=Plur	NOUN
biscuit	ADJ__Number=Sing	ADJ
biste	NOUN__Gender=Masc|Number=Sing	NOUN
bistec	NOUN__Gender=Masc|Number=Sing	NOUN
bitters	NOUN__Gender=Masc|Number=Plur	NOUN
bizcochito	NOUN__Gender=Masc|Number=Sing	NOUN
bizcocho	NOUN__Gender=Masc|Number=Sing	NOUN
bizcochuelo	NOUN__Gender=Masc|Number=Sing	NOUN
bleo	NOUN__Gender=Masc|Number=Sing	NOUN
blini	NOUN__Gender=Masc|Number=Plur	NOUN
bocachico	NOUN__Gender=Masc|Number=Sing	NOUN
bocadillo	NOUN__Gender=Masc|Number=Sing	NOUN
bocadito	NOUN__Gender=Masc|Number=Sing	NOUN
boerewors	NOUN__Gender=Masc|Number=Plur	NOUN
boliño	NOUN__Gender=Masc|Number=Sing	NOUN
bollo	NOUN__Gender=Masc|Number=Sing	NOUN
bolognesa	VERB__Mood=Ind|Number=Sing|Person=3|Tense=Pres|VerbForm=Fin	VERB
bolonesa	VERB__Mood=Ind|Number=Sing|Person=3|Tense=Pres|VerbForm=Fin	VERB
boniato	NOUN__Gender=Masc|Number=Sing	NOUN
boronia	NOUN__Gender=Fem|Number=Sing	NOUN
botana	NOUN__Gender=Fem|Number=Sing	NOUN
brandy	NOUN__Gender=Masc|Number=Sing	NOUN
bratwurst	NOUN__Gender=Masc|Number=Plur	NOUN
bread	NOUN___	NOUN
breakfast	NOUN__Gender=Fem|Number=Sing	NOUN
bretaña	NOUN__Gender=Fem|Number=Sing	NOUN
brevas	NOUN__Gender=Fem|Number=Plur	NOUN
brioches	NOUN__Gender=Masc|Number=Plur	NOUN
broaster	NOUN__Gender=Masc|Number=Sing	NOUN
broccoflower	NOUN__Gender=Masc|Number=Plur	NOUN
brocheta	NOUN__Gender=Fem|Number=Sing	NOUN
brocoli	NOUN__Gender=Masc|Number=Sing	NOUN
brotzeit	NOUN__Gender=Masc|Number=Plur	NOUN
brunch	NOUN__Gender=Masc|Number=Sing	NOUN
budare	NOUN__Gender=Masc|Number=Plur	NOUN
budin	NOUN__Gender=Masc|Number=Plur	NOUN
budines	NOUN__Gender=Masc|Number=Plur	NOUN
bufes	NOUN__Gender=Masc|Number=Plur	NOUN
bungeoppang	NOUN__Gender=Masc|Number=Plur	NOUN
bunuelo	NOUN__Gender=Masc|Number=Sing	NOUN
buñuelo	NOUN__Gender=Masc|Number=Sing	NOUN
burasa	VERB__Mood=Ind|Number=Sing|Person=3|Tense=Pres|VerbForm=Fin	VERB
burek	NOUN__Gender=Masc|Number=Plur	NOUN
butifarra	NOUN__Gender=Fem|Number=Sing	NOUN
caballa	NOUN__Gender=Fem|Number=Sing	NOUN
cabra	NOUN__Gender=Fem|Number=Sing	NOUN
cabrito	NOUN__Gender=Masc|Number=Sing	NOUN
cacahuate	NOUN__Gender=Masc|Number=Sing	NOUN
cacahuete	NOUN__Gender=Masc|Number=Sing	NOUN
cacao	NOUN__Gender=Masc|Number=Sing	NOUN
cachapa	NOUN__Gender=Fem|Number=Sing	NOUN
cafe	NOUN__Gender=Masc|Number=Sing	NOUN
cake	NOUN__Gender=Fem|Number=Sing	NOUN
calabacin	VERB__Mood=Ind|Number=Sing|Person=3|Tense=Past|VerbForm=Fin	VERB
calabaza	NOUN__Gender=Fem|Number=Sing	NOUN
calabazo	ADJ__Gender=Fem|Number=Sing	ADJ
calamar	VERB__VerbForm=Inf	VERB
caldo	NOUN__Gender=Masc|Number=Sing	NOUN
calducho	ADJ__Gender=Masc|Number=Sing|VerbForm=Part	ADJ
calentado	ADJ__Gender=Masc|Number=Sing|VerbForm=Part	ADJ
calentao	VERB__Mood=Ind|Number=Sing|Person=3|Tense=Past|VerbForm=Fin	VERB
camaron	VERB__Mood=Ind|Number=Plur|Person=3|Tense=Past|VerbForm=Fin	VERB
camembert	NOUN__Gender=Masc|Number=Sing	NOUN
camote	NOUN__Gender=Masc|Number=Sing	NOUN
campari	NOUN__Number=Sing	NOUN
canela	ADJ__Number=Sing	ADJ
canelones	NOUN__Gender=Masc|Number=Plur	NOUN
canjica	ADJ__Gender=Fem|Number=Sing	ADJ
canonigos	NOUN__Gender=Masc|Number=Plur	NOUN
cantimpalo	NOUN__Gender=Masc|Number=Sing	NOUN
cappuccino	ADJ__Gender=Masc|Number=Sing	ADJ
capuchino	NOUN__Gender=Masc|Number=Sing	NOUN
caramañola	NOUN__Gender=Fem|Number=Sing	NOUN
caramelo	NOUN__Gender=Masc|Number=Sing	NOUN
caraotas	NOUN__Gender=Fem|Number=Plur	NOUN
cargamanto	NOUN__Gender=Masc|Number=Sing	NOUN
carimañola	NOUN__Gender=Fem|Number=Sing	NOUN
carne	NOUN__Gender=Fem|Number=Sing	NOUN
carnita	NOUN__Gender=Fem|Number=Sing	NOUN
caruru	VERB__Mood=Ind|Number=Sing|Person=3|Tense=Past|VerbForm=Fin	VERB
casabe	NOUN__Gender=Masc|Number=Sing	NOUN
cassata	NOUN__Gender=Fem|Number=Sing	NOUN
cassis	NOUN__Gender=Masc	NOUN
cassoulet	ADJ__Number=Sing	ADJ
catibias	ADJ__Gender=Fem|Number=Plur	ADJ
caupi	VERB__Mood=Ind|Number=Sing|Person=3|Tense=Past|VerbForm=Fin	VERB
cayeye	VERB__Mood=Ind|Number=Sing|Person=3|Tense=Past|VerbForm=Fin	VERB
cazuela	NOUN__Gender=Fem|Number=Sing	NOUN
cebada	NOUN__Gender=Fem|Number=Sing	NOUN
cebolla	NOUN__Gender=Fem|Number=Sing	NOUN
cebolleta	ADJ__Number=Sing	ADJ
cebollin	NOUN___	NOUN
cebollino	NOUN__Gender=Masc|Number=Sing	NOUN
cena	NOUN__Gender=Fem|Number=Sing	NOUN
centeno	NOUN__Gender=Masc|Number=Sing	NOUN
cerdo	NOUN__Gender=Masc|Number=Sing	NOUN
cereal	NOUN__Gender=Masc|Number=Sing	NOUN
cereza	NOUN__Gender=Fem|Number=Sing	NOUN
cerveza	NOUN__Gender=Fem|Number=Sing	NOUN
ceviche	NOUN__Gender=Masc|Number=Sing	NOUN
chaap	VERB__Mood=Ind|Number=Sing|Person=3|Tense=Past|VerbForm=Fin	VERB
chaat	VERB__Mood=Ind|Number=Sing|Person=3|Tense=Past|VerbForm=Fin	VERB
chacarero	NOUN__Gender=Masc|Number=Sing	NOUN
chadon	NOUN__Gender=Masc|Number=Sing	NOUN
chai	ADJ__Gender=Masc|Number=Sing	ADJ
chakkuli	VERB__Mood=Ind|Number=Sing|Person=3|Tense=Past|VerbForm=Fin	VERB
chalote	NOUN__Gender=Masc|Number=Sing	NOUN
champagne	NOUN__Gender=Masc|Number=Sing	NOUN
champan	VERB__Mood=Ind|Number=Plur|Person=3|Tense=Pres|VerbForm=Fin	VERB
champana	NOUN__Gender=Fem|Number=Sing	NOUN
champaña	NOUN__Gender=Masc|Number=Sing	NOUN
champinon	VERB__Mood=Ind|Number=Sing|Person=3|Tense=Past|VerbForm=Fin	VERB
champiñon	VERB__Mood=Ind|Number=Sing|Person=3|Tense=Past|VerbForm=Fin	VERB
champus	VERB__Mood=Ind|Number=Sing|Person=3|Tense=Past|VerbForm=Fin	VERB
chanachur	VERB__Mood=Ind|Number=Sing|Person=3|Tense=Past|VerbForm=Fin	VERB
chancaca	NOUN__Gender=Fem|Number=Sing	NOUN
changua	NOUN__Gender=Fem|Number=Sing	NOUN
channa	VERB__Mood=Ind|Number=Sing|Person=3|Tense=Past|VerbForm=Fin	VERB
chaparritas	ADJ__Gender=Fem|Number=Plur	ADJ
chaucha	NOUN__Gender=Fem|Number=Sing	NOUN
chebureki	VERB__Mood=Ind|Number=Sing|Person=3|Tense=Past|VerbForm=Fin	VERB
cheesecake	NOUN__Gender=Masc|Number=Sing	NOUN
chholey	NOUN__Gender=Fem|Number=Sing	NOUN
chicha	NOUN__Gender=Fem|Number=Sing	NOUN
chicharron	VERB__Mood=Ind|Number=Plur|Person=3|Tense=Past|VerbForm=Fin	VERB
chicharronada	ADJ__Gender=Fem|Number=Sing|VerbForm=Part	ADJ
chicharrones	NOUN__Gender=Masc|Number=Plur	NOUN
chicha	NOUN__Gender=Fem|Number=Sing	NOUN
chicle	NOUN__Gender=Masc|Number=Sing	NOUN
chikuwa	VERB__Mood=Ind|Number=Sing|Person=3|Tense=Past|VerbForm=Fin	VERB
chilaquiles	NOUN__Gender=Masc|Number=Plur	NOUN
chili	ADJ__Number=Sing	ADJ
chiltepes	VERB__Mood=Ind|Number=Sing|Person=3|Tense=Past|VerbForm=Fin	VERB
chimichurri	NOUN__Gender=Masc|Number=Sing	NOUN
chinchurria	ADJ__Gender=Fem|Number=Sing	ADJ
chip	NOUN__Gender=Masc|Number=Sing	NOUN
chipotle	NOUN__Gender=Masc|Number=Sing	NOUN
chiverre	NOUN__Gender=Masc|Number=Sing	NOUN
chivo	NOUN__Gender=Masc|Number=Sing	NOUN
choclo	NOUN__Gender=Masc|Number=Sing	NOUN
choclotanda	NOUN__Gender=Fem|Number=Sing	NOUN
chocolate	NOUN__Gender=Masc|Number=Sing	NOUN
chocolatina	NOUN__Gender=Fem|Number=Sing	NOUN
chocolatin	VERB__Mood=Ind|Number=Sing|Person=3|Tense=Past|VerbForm=Fin	VERB
choncholies	NOUN__Gender=Fem|Number=Plur	NOUN
choricillo	NOUN__Gender=Masc|Number=Sing	NOUN
choripan	NOUN__Gender=Masc|Number=Sing	NOUN
chorizo	NOUN__Gender=Masc|Number=Sing	NOUN
choux	ADJ__Number=Sing	ADJ
chucrut	NOUN__Gender=Masc|Number=Sing	NOUN
chuleta	NOUN__Gender=Fem|Number=Sing	NOUN
chuño	NOUN__Gender=Masc|Number=Sing	NOUN
chupe	NOUN__Gender=Fem|Number=Sing	NOUN
chupichupi	VERB__Mood=Ind|Number=Sing|Person=3|Tense=Past|VerbForm=Fin	VERB
churrasco	NOUN__Gender=Masc|Number=Sing	NOUN
churro	NOUN__Gender=Masc|Number=Sing	NOUN
churumuri	VERB__Mood=Ind|Number=Sing|Person=3|Tense=Past|VerbForm=Fin	VERB
chutney	NOUN__Gender=Masc|Number=Sing	NOUN
chutneys	NOUN__Gender=Masc|Number=Plur	NOUN
cidra	NOUN__Gender=Fem|Number=Sing	NOUN
ciganska	VERB__Mood=Ind|Number=Sing|Person=3|Tense=Past|VerbForm=Fin	VERB
cilantro	NOUN__Gender=Masc|Number=Sing	NOUN
cinzano	NOUN__Gender=Masc|Number=Sing	NOUN
ciruela	NOUN__Gender=Fem|Number=Sing	NOUN
clavo	NOUN__Gender=Masc|Number=Sing	NOUN
clicquot	VERB__Mood=Ind|Number=Sing|Person=3|Tense=Past|VerbForm=Fin	VERB
coalho	VERB__Mood=Ind|Number=Sing|Person=3|Tense=Past|VerbForm=Fin	VERB
coca	NOUN__Gender=Fem|Number=Sing	NOUN
cocacola	NOUN__Gender=Masc|Number=Sing	NOUN
coca	NOUN__Gender=Fem|Number=Sing	NOUN
-	PUNCT__PunctType=Dash	PUNCT
cola	NOUN__Gender=Fem|Number=Sing	NOUN
cocada	ADJ__Gender=Fem|Number=Sing|VerbForm=Part	ADJ
coco	NOUN__Gender=Masc|Number=Sing	NOUN
cocoa	NOUN___	NOUN
coctel	NOUN__Gender=Masc|Number=Sing	NOUN
codornices	NOUN__Gender=Fem|Number=Plur	NOUN
codorniz	NOUN__Gender=Fem|Number=Sing	NOUN
cognacs	NOUN__Gender=Masc|Number=Plur	NOUN
cointreau	ADV___	ADV
colacion	NOUN__Gender=Fem|Number=Sing	NOUN
colada	NOUN__Gender=Fem|Number=Sing	NOUN
coles	NOUN__Gender=Fem|Number=Plur	NOUN
coliflor	NOUN__Gender=Fem|Number=Sing	NOUN
comida	NOUN__Gender=Fem|Number=Sing	NOUN
comino	NOUN__Gender=Masc|Number=Sing	NOUN
compango	NOUN__Gender=Masc|Number=Sing	NOUN
compota	NOUN__Gender=Fem|Number=Sing	NOUN
conacs	VERB__Mood=Ind|Number=Sing|Person=3|Tense=Past|VerbForm=Fin	VERB
concassee	NOUN__Gender=Masc|Number=Sing	NOUN
condimento	NOUN__Gender=Masc|Number=Sing	NOUN
conserva	VERB__Mood=Ind|Number=Sing|Person=3|Tense=Pres|VerbForm=Fin	VERB
consome	NOUN__Gender=Masc|Number=Sing	NOUN
cordero	NOUN__Gender=Masc|Number=Sing	NOUN
corozo	NOUN__Gender=Masc|Number=Sing	NOUN
costilla	NOUN__Gender=Fem|Number=Sing	NOUN
cotoletta	VERB__Mood=Ind|Number=Sing|Person=3|Tense=Past|VerbForm=Fin	VERB
coulis	NOUN__Gender=Fem|Number=Sing	NOUN
courvoisier	DET__Number=Sing|PronType=Ind	DET
crème	NOUN__Gender=Fem|Number=Sing	NOUN
crepe	ADJ__Number=Sing	ADJ
crespells	VERB__Mood=Ind|Number=Sing|Person=3|Tense=Past|VerbForm=Fin	VERB
criadillas	NOUN__Gender=Fem|Number=Plur	NOUN
croissant	ADJ__Number=Sing	ADJ
croqueta	NOUN__Gender=Fem|Number=Sing	NOUN
cruasan	VERB__Mood=Ind|Number=Plur|Person=3|Tense=Pres|VerbForm=Fin	VERB
cuajada	ADJ__Gender=Fem|Number=Sing|VerbForm=Part	ADJ
cuajadita	VERB__Mood=Ind|Number=Sing|Person=3|Tense=Pres|VerbForm=Fin	VERB
cup	NOUN__Gender=Fem|Number=Sing	NOUN
-	PUNCT__PunctType=Dash	PUNCT
cake	NOUN__Gender=Fem|Number=Sing	NOUN
curcuma	NOUN__Gender=Masc|Number=Sing	NOUN
curri	VERB__Mood=Ind|Number=Sing|Person=3|Tense=Past|VerbForm=Fin	VERB
curry	NOUN__Gender=Masc|Number=Sing	NOUN
currywurst	ADJ__Number=Sing	ADJ
cutty	VERB__Mood=Ind|Number=Sing|Person=3|Tense=Past|VerbForm=Fin	VERB
cuy	NOUN___	NOUN
cynar	VERB__VerbForm=Inf	VERB
dabeli	VERB__Mood=Ind|Number=Sing|Person=3|Tense=Past|VerbForm=Fin	VERB
dahi	VERB__Mood=Ind|Number=Sing|Person=3|Tense=Past|VerbForm=Fin	VERB
dahl	NOUN__Gender=Masc|Number=Sing	NOUN
damasco	NOUN__Gender=Masc|Number=Sing	NOUN
datil	ADJ__Number=Sing	ADJ
delicatesen	VERB__Mood=Sub|Number=Plur|Person=3|Tense=Imp|VerbForm=Fin	VERB
desayuno	NOUN__Gender=Masc|Number=Sing	NOUN
dewars	VERB__Mood=Ind|Number=Sing|Person=3|Tense=Past|VerbForm=Fin	VERB
dona	VERB__Mood=Ind|Number=Sing|Person=3|Tense=Pres|VerbForm=Fin	VERB
donut	NOUN__Gender=Masc|Number=Sing	NOUN
dosais	VERB__Mood=Ind|Number=Sing|Person=3|Tense=Past|VerbForm=Fin	VERB
dulce	ADJ__Number=Sing	ADJ
dumpling	NOUN__Gender=Masc|Number=Sing	NOUN
durazno	NOUN__Gender=Masc|Number=Sing	NOUN
eclair	NOUN__Gender=Fem|Number=Sing	NOUN
elote	NOUN__Gender=Masc|Number=Sing	NOUN
embutido	NOUN__Gender=Masc|Number=Sing	NOUN
empanada	NOUN__Gender=Fem|Number=Sing	NOUN
empanadilla	NOUN__Gender=Fem|Number=Sing	NOUN
empanadita	VERB__Mood=Ind|Number=Sing|Person=3|Tense=Pres|VerbForm=Fin	VERB
empanizao	NOUN__Gender=Masc|Number=Sing	NOUN
emparedado	ADJ__Gender=Masc|Number=Sing|VerbForm=Part	ADJ
encurtido	NOUN__Gender=Masc|Number=Sing	NOUN
enlatado	ADJ__Gender=Masc|Number=Sing|VerbForm=Part	ADJ
ensalada	NOUN__Gender=Fem|Number=Sing	NOUN
entresijo	NOUN__Gender=Masc|Number=Sing	NOUN
envuelto	ADJ__Gender=Masc|Number=Sing	ADJ
enyucado	ADJ__Gender=Masc|Number=Sing|VerbForm=Part	ADJ
eristoff	VERB__VerbForm=Inf	VERB
escabeche	ADJ__Gender=Masc|Number=Sing	ADJ
escalope	NOUN__Gender=Masc|Number=Sing	NOUN
escarola	NOUN__Gender=Fem|Number=Sing	NOUN
espagueti	NOUN__Gender=Masc|Number=Sing	NOUN
espaguetti	ADJ__Number=Sing	ADJ
esparrago	NOUN__Gender=Masc|Number=Sing	NOUN
espinaca	NOUN__Gender=Fem|Number=Sing	NOUN
estofado	ADJ__Gender=Masc|Number=Sing|VerbForm=Part	ADJ
estragon	NOUN__Gender=Masc|Number=Sing	NOUN
falafel	NOUN__Gender=Masc|Number=Sing	NOUN
fecula	NOUN__Gender=Fem|Number=Sing	NOUN
fernet	NOUN__Gender=Masc|Number=Sing	NOUN
feuillatte	VERB__Mood=Ind|Number=Sing|Person=3|Tense=Past|VerbForm=Fin	VERB
fiambre	NOUN__Gender=Masc|Number=Sing	NOUN
fideo	NOUN__Gender=Masc|Number=Sing	NOUN
filet	ADJ__Number=Sing	ADJ
filete	NOUN__Gender=Masc|Number=Sing	NOUN
fish	NOUN___	NOUN
fishcake	VERB__Mood=Ind|Number=Sing|Person=3|Tense=Past|VerbForm=Fin	VERB
flan	NOUN__Gender=Masc|Number=Sing	NOUN
focaccia	NOUN__Gender=Fem|Number=Sing	NOUN
frambuesa	NOUN__Gender=Fem|Number=Sing	NOUN
frejol	VERB__Mood=Ind|Number=Sing|Person=3|Tense=Past|VerbForm=Fin	VERB
fresa	NOUN__Gender=Fem|Number=Sing	NOUN
frijol	NOUN__Gender=Masc|Number=Sing	NOUN
frikandellen	VERB__Mood=Ind|Number=Plur|Person=3|Tense=Pres|VerbForm=Fin	VERB
frisuelo	NOUN__Gender=Fem|Number=Sing	NOUN
fritanga	VERB__Mood=Sub|Number=Sing|Person=3|Tense=Pres|VerbForm=Fin	VERB
fritas	ADJ__Gender=Fem|Number=Plur	ADJ
fritura	NOUN__Gender=Fem|Number=Sing	NOUN
fromage	NOUN___	NOUN
fruta	NOUN__Gender=Fem|Number=Sing	NOUN
frutilla	NOUN__Gender=Fem|Number=Sing	NOUN
fufu	NOUN__Gender=Masc|Number=Sing	NOUN
fugazzeta	NOUN__Gender=Fem|Number=Sing	NOUN
funche	NOUN__Gender=Fem|Number=Sing	NOUN
gacha	NOUN__Gender=Fem|Number=Sing	NOUN
galgueria	NOUN__Gender=Fem|Number=Sing	NOUN
galleta	NOUN__Gender=Fem|Number=Sing	NOUN
galletita	NOUN__Gender=Fem|Number=Sing	NOUN
gamba	NOUN__Gender=Fem|Number=Sing	NOUN
gandules	NOUN__Gender=Masc|Number=Plur	NOUN
ganso	NOUN__Gender=Masc|Number=Sing	NOUN
garbanzo	NOUN__Gender=Masc|Number=Sing	NOUN
gaseosa	ADJ__Gender=Fem|Number=Sing	ADJ
gelatina	NOUN__Gender=Fem|Number=Sing	NOUN
gimbap	VERB__Mood=Ind|Number=Sing|Person=3|Tense=Past|VerbForm=Fin	VERB
ginebra	NOUN__Gender=Fem|Number=Sing	NOUN
girasol	NOUN__Gender=Masc|Number=Sing	NOUN
glenfiddich	VERB__Mood=Ind|Number=Sing|Person=3|Tense=Past|VerbForm=Fin	VERB
glenlivet	VERB__Mood=Ind|Number=Sing|Person=3|Tense=Past|VerbForm=Fin	VERB
gofio	NOUN__Gender=Masc|Number=Sing	NOUN
gofre	NOUN__Gender=Masc|Number=Sing	NOUN
golosina	NOUN__Gender=Fem|Number=Sing	NOUN
gouda	NOUN__Gender=Masc|Number=Sing	NOUN
granadilla	NOUN__Gender=Fem|Number=Sing	NOUN
granola	NOUN__Gender=Fem|Number=Sing	NOUN
grants	NOUN___	NOUN
gravy	ADJ__Number=Sing	ADJ
grille	NOUN___	NOUN
griot	NOUN__Gender=Masc|Number=Plur	NOUN
grosella	NOUN__Gender=Fem|Number=Sing	NOUN
guacamole	NOUN__Gender=Masc|Number=Sing	NOUN
guayaba	VERB__Mood=Ind|Number=Sing|Person=3|Tense=Imp|VerbForm=Fin	VERB
guayoyo	NOUN__Gender=Masc|Number=Sing	NOUN
guinda	NOUN__Gender=Fem|Number=Sing	NOUN
guindilla	NOUN__Gender=Fem|Number=Sing	NOUN
guineos	ADJ__Gender=Masc|Number=Plur	ADJ
guisado	ADJ__Gender=Masc|Number=Sing|VerbForm=Part	ADJ
guisante	ADJ__Number=Sing	ADJ
gyros	NOUN__Gender=Masc|Number=Plur	NOUN
haba	VERB__Mood=Ind|Number=Sing|Person=3|Tense=Imp|VerbForm=Fin	VERB
habichuela	NOUN__Gender=Fem|Number=Plur	NOUN
hallaca	NOUN__Gender=Fem|Number=Sing	NOUN
hallaquita	VERB__Mood=Ind|Number=Sing|Person=3|Tense=Pres|VerbForm=Fin	VERB
hallulla	NOUN__Gender=Fem|Number=Sing	NOUN
halumi	NOUN__Gender=Masc|Number=Sing	NOUN
hamburguesa	NOUN__Gender=Fem|Number=Sing	NOUN
harina	NOUN__Gender=Fem|Number=Sing	NOUN
harzer	NOUN__Gender=Masc|Number=Sing	NOUN
haytalya	NOUN__Gender=Masc|Number=Sing	NOUN
hbejza	NOUN__Gender=Masc|Number=Sing	NOUN
heidsieck	NOUN__Gender=Masc|Number=Sing	NOUN
heineken	NOUN__Gender=Masc|Number=Sing	NOUN
helado	ADJ__Gender=Masc|Number=Sing|VerbForm=Part	ADJ
hennessy	NOUN__Gender=Masc|Number=Sing	NOUN
hierba	NOUN__Gender=Fem|Number=Sing	NOUN
hierbabuena	NOUN__Gender=Fem|Number=Sing	NOUN
higado	ADJ__Gender=Masc|Number=Sing|VerbForm=Part	ADJ
higo	NOUN__Gender=Masc|Number=Sing	NOUN
hinojo	NOUN__Gender=Masc|Number=Sing	NOUN
hogao	NOUN__Gender=Masc|Number=Sing	NOUN
hogo	NOUN__Gender=Masc|Number=Sing	NOUN
hojaldre	NOUN__Gender=Masc|Number=Sing	NOUN
hojuela	NOUN__Gender=Fem|Number=Sing	NOUN
hoppin	VERB__Mood=Ind|Number=Sing|Person=3|Tense=Past|VerbForm=Fin	VERB
hortaliza	NOUN__Gender=Fem|Number=Sing	NOUN
hotteok	NOUN__Gender=Masc|Number=Sing	NOUN
htamin	NOUN__Gender=Masc|Number=Sing	NOUN
hummus	NOUN__Gender=Masc|Number=Sing	NOUN
ibia	VERB__Mood=Ind|Number=Sing|Person=3|Tense=Pres|VerbForm=Fin	VERB
idli	VERB__Mood=Ind|Number=Sing|Person=3|Tense=Past|VerbForm=Fin	VERB
imagawayaki	VERB__Mood=Ind|Number=Sing|Person=3|Tense=Past|VerbForm=Fin	VERB
imqaret	VERB__Mood=Ind|Number=Sing|Person=3|Tense=Past|VerbForm=Fin	VERB
infusion	ADJ__Number=Sing	ADJ
irkotta	VERB__Mood=Ind|Number=Sing|Person=3|Tense=Past|VerbForm=Fin	VERB
islak	VERB__Mood=Ind|Number=Sing|Person=3|Tense=Past|VerbForm=Fin	VERB
itatitaia	VERB__Mood=Ind|Number=Sing|Person=3|Tense=Past|VerbForm=Fin	VERB
jaegermeister	NOUN__Gender=Masc|Number=Sing	NOUN
jaggery	VERB__Mood=Ind|Number=Sing|Person=3|Tense=Past|VerbForm=Fin	VERB
jalapeno	NOUN__Gender=Masc|Number=Sing	NOUN
jalapeño	NOUN__Gender=Masc|Number=Sing	NOUN
jalea	VERB__Mood=Ind|Number=Sing|Person=3|Tense=Pres|VerbForm=Fin	VERB
jamon	NOUN__Gender=Masc|Number=Sing	NOUN
jengibre	NOUN__Gender=Masc|Number=Sing	NOUN
jericalla	VERB__Mood=Ind|Number=Sing|Person=3|Tense=Pres|VerbForm=Fin	VERB
jhal	VERB__Mood=Ind|Number=Sing|Person=3|Tense=Past|VerbForm=Fin	VERB
jijas	NOUN__Gender=Fem|Number=Plur	NOUN
jitomate	NOUN__Gender=Masc|Number=Sing	NOUN
johnnycake	VERB__Mood=Ind|Number=Sing|Person=3|Tense=Past|VerbForm=Fin	VERB
jojoto	VERB__Mood=Ind|Number=Sing|Person=3|Tense=Past|VerbForm=Fin	VERB
jonnycake	VERB__Mood=Ind|Number=Sing|Person=3|Tense=Past|VerbForm=Fin	VERB
jugo	NOUN__Gender=Masc|Number=Sing	NOUN
julepes	VERB__Mood=Ind|Number=Sing|Person=3|Tense=Past|VerbForm=Fin	VERB
kaassouffle	NOUN__Gender=Masc|Number=Plur	NOUN
kacang	NOUN__Gender=Masc|Number=Plur	NOUN
kaffee	NOUN__Gender=Masc|Number=Plur	NOUN
kaki	NOUN__Gender=Masc|Number=Sing	NOUN
kakoiyael	NOUN__Gender=Masc|Number=Plur	NOUN
kalacs	NOUN__Gender=Masc|Number=Plur	NOUN
kalamay	NOUN__Gender=Masc|Number=Plur	NOUN
karamanducas	ADJ__Gender=Fem|Number=Plur	ADJ
karamanduka	NOUN__Gender=Masc|Number=Plur	NOUN
kebab	NOUN__Gender=Masc|Number=Sing	NOUN
kebap	NOUN__Gender=Masc|Number=Plur	NOUN
kechup	NOUN__Gender=Masc|Number=Plur	NOUN
kellogg	NOUN__Gender=Masc|Number=Plur	NOUN
kenkey	NOUN__Gender=Masc|Number=Plur	NOUN
ketchup	NOUN__Gender=Masc|Number=Sing	NOUN
ketel	NOUN__Gender=Masc|Number=Plur	NOUN
kiwi	NOUN__Gender=Masc|Number=Sing	NOUN
koskera	VERB__Mood=Sub|Number=Sing|Person=3|Tense=Imp|VerbForm=Fin	VERB
kumala	NOUN__Gender=Masc|Number=Plur	NOUN
lacteo	NOUN__Gender=Masc|Number=Sing	NOUN
lahmacun	ADJ__Number=Sing	ADJ
lait	NOUN___	NOUN
lanche	NOUN__Gender=Fem|Number=Sing	NOUN
langosta	NOUN__Gender=Fem|Number=Sing	NOUN
langostin	ADJ__Number=Sing	ADJ
langostino	NOUN__Gender=Masc|Number=Sing	NOUN
lasana	NOUN__Gender=Fem|Number=Sing	NOUN
lasaña	NOUN__Gender=Fem|Number=Sing	NOUN
latte	NOUN__Gender=Masc|Number=Sing	NOUN
laurel	NOUN__Gender=Masc|Number=Sing	NOUN
leberk	ADJ__Number=Sing	ADJ
leberwurst	ADJ__Number=Sing	ADJ
leche	NOUN__Gender=Fem|Number=Sing	NOUN
lechera	ADJ__Gender=Fem|Number=Sing	ADJ
lechona	NOUN__Gender=Fem|Number=Sing	NOUN
lechuga	NOUN__Gender=Fem|Number=Sing	NOUN
legumbre	NOUN__Gender=Fem|Number=Sing	NOUN
leite	NOUN__Gender=Masc|Number=Sing	NOUN
lemang	ADJ__Number=Sing	ADJ
lengua	NOUN__Gender=Fem|Number=Sing	NOUN
lenguado	ADJ__Gender=Masc|Number=Sing|VerbForm=Part	ADJ
lenteja	NOUN__Gender=Fem|Number=Sing	NOUN
levadura	NOUN__Gender=Fem|Number=Sing	NOUN
licor	NOUN__Gender=Masc|Number=Sing	NOUN
lima	NOUN__Gender=Fem|Number=Sing	NOUN
limon	NOUN__Gender=Masc|Number=Sing	NOUN
limonada	NOUN__Gender=Fem|Number=Sing	NOUN
linaza	NOUN__Gender=Fem|Number=Sing	NOUN
lindemans	ADJ__Number=Sing	ADJ
liwet	ADJ__Number=Sing	ADJ
llajwa	ADJ__Number=Sing	ADJ
llapingachos	ADJ__Gender=Masc|Number=Plur|VerbForm=Part	ADJ
llardons	ADJ__Number=Sing	ADJ
llushtu	ADJ__Number=Sing	ADJ
lokma	ADJ__Number=Sing	ADJ
lomillo	NOUN__Gender=Masc|Number=Sing	NOUN
lomito	NOUN__Gender=Masc|Number=Sing	NOUN
lomo	NOUN__Gender=Masc|Number=Sing	NOUN
loncha	NOUN__Gender=Fem|Number=Sing	NOUN
longanicilla	NOUN__Gender=Fem|Number=Sing	NOUN
longaniza	NOUN__Gender=Fem|Number=Sing	NOUN
lucuma	ADJ__Number=Sing	ADJ
lulo	NOUN__Gender=Masc|Number=Sing	NOUN
lunch	NOUN___	NOUN
lunumiris	ADJ__Number=Sing	ADJ
lupulo	NOUN__Gender=Masc|Number=Sing	NOUN
macallan	VERB__Mood=Ind|Number=Plur|Person=3|Tense=Pres|VerbForm=Fin	VERB
macarron	VERB__Mood=Ind|Number=Plur|Person=3|Tense=Past|VerbForm=Fin	VERB
macchiato	NOUN__Gender=Masc|Number=Sing	NOUN
macdonald	NOUN__Gender=Fem|Number=Sing	NOUN
machica	NOUN__Gender=Fem|Number=Sing	NOUN
machuquillo	NOUN__Gender=Masc|Number=Sing	NOUN
mahonesa	NOUN__Gender=Fem|Number=Sing	NOUN
maicena	NOUN__Gender=Fem|Number=Sing	NOUN
maiz	NOUN__Gender=Masc|Number=Sing	NOUN
maizena	NOUN__Gender=Fem|Number=Sing	NOUN
malta	NOUN__Gender=Fem|Number=Sing	NOUN
malteada	ADJ__Gender=Fem|Number=Sing|VerbForm=Part	ADJ
mandarina	NOUN__Gender=Fem|Number=Sing	NOUN
mandioca	NOUN__Gender=Fem|Number=Sing	NOUN
mandoca	VERB__Mood=Ind|Number=Sing|Person=3|Tense=Pres|VerbForm=Fin	VERB
mango	NOUN__Gender=Masc|Number=Sing	NOUN
mani	ADJ__Number=Sing	ADJ
manjar	NOUN__Gender=Masc|Number=Sing	NOUN
manteca	NOUN__Gender=Fem|Number=Sing	NOUN
mantecada	ADJ__Gender=Fem|Number=Sing|VerbForm=Part	ADJ
mantecado	NOUN__Gender=Masc|Number=Sing	NOUN
mantequilla	NOUN__Gender=Fem|Number=Sing	NOUN
manzana	NOUN__Gender=Fem|Number=Sing	NOUN
manzanilla	NOUN__Gender=Fem|Number=Sing	NOUN
maracuya	NOUN__Gender=Masc|Number=Sing	NOUN
margarina	NOUN__Gender=Fem|Number=Sing	NOUN
margarita	NOUN__Gender=Fem|Number=Sing	NOUN
marisco	NOUN__Gender=Masc|Number=Sing	NOUN
marmoleado	ADJ__Gender=Masc|Number=Sing|VerbForm=Part	ADJ
marnier	NOUN__Gender=Fem|Number=Sing	NOUN
marranita	VERB__Mood=Ind|Number=Sing|Person=3|Tense=Pres|VerbForm=Fin	VERB
marrano	NOUN__Gender=Masc|Number=Sing	NOUN
martell	NOUN__Gender=Masc|Number=Sing	NOUN
martini	NOUN__Gender=Masc|Number=Sing	NOUN
masado	ADJ__Gender=Masc|Number=Sing|VerbForm=Part	ADJ
masala	ADJ__Gender=Masc|Number=Sing	ADJ
masato	NOUN__Gender=Masc|Number=Sing	NOUN
mate	NOUN__Gender=Masc|Number=Sing	NOUN
mayonesa	NOUN__Gender=Fem|Number=Sing	NOUN
mazamorra	NOUN__Gender=Fem|Number=Sing	NOUN
mazapan	NOUN__NumForm=Digit	NOUN
mazorca	NOUN__Gender=Fem|Number=Sing	NOUN
mcdonalds	NOUN___	NOUN
mecato	NOUN__Gender=Masc|Number=Sing	NOUN
mejillon	NOUN__Gender=Fem|Number=Sing	NOUN
melao	NOUN__Gender=Masc|Number=Sing	NOUN
melaza	NOUN__Gender=Fem|Number=Sing	NOUN
melocoton	NOUN__Gender=Fem|Number=Sing	NOUN
melon	ADJ__Number=Sing	ADJ
membrillo	NOUN__Gender=Masc|Number=Sing	NOUN
menudencia	NOUN__Gender=Fem|Number=Sing	NOUN
merengon	NOUN__Gender=Fem|Number=Sing	NOUN
merengue	ADJ__Number=Sing	ADJ
merienda	NOUN__Gender=Fem|Number=Sing	NOUN
mermelada	NOUN__Gender=Fem|Number=Sing	NOUN
mero	ADJ__Gender=Masc|Number=Sing	ADJ
mezcolanza	NOUN__Gender=Fem|Number=Sing	NOUN
mezze	NOUN__Gender=Fem|Number=Sing	NOUN
miel	NOUN__Gender=Fem|Number=Sing	NOUN
miga	NOUN__Gender=Fem|Number=Sing	NOUN
milanesa	ADJ__Gender=Fem|Number=Sing	ADJ
milhoja	NOUN__Gender=Fem|Number=Sing	NOUN
mirepoix	NOUN__Gender=Masc|Number=Sing	NOUN
mofongo	NOUN__Gender=Masc|Number=Sing	NOUN
mole	NOUN__Gender=Masc|Number=Sing	NOUN
moleque	SCONJ___	SCONJ
mollete	NOUN__Gender=Masc|Number=Sing	NOUN
mondongo	NOUN__Gender=Masc|Number=Sing	NOUN
mora	NOUN__Gender=Fem|Number=Sing	NOUN
morcilla	NOUN__Gender=Fem|Number=Sing	NOUN
morcipan	VERB__Mood=Ind|Number=Plur|Person=3|Tense=Pres|VerbForm=Fin	VERB
morron	VERB__Mood=Ind|Number=Plur|Person=3|Tense=Past|VerbForm=Fin	VERB
mortadela	NOUN__Gender=Fem|Number=Sing	NOUN
moskowskaya	ADV___	ADV
mostaza	NOUN__Gender=Fem|Number=Sing	NOUN
mote	NOUN__Gender=Masc|Number=Sing	NOUN
motuleño	NOUN__Gender=Masc|Number=Sing	NOUN
mousse	ADJ__Number=Sing	ADJ
mozarella	NOUN__Gender=Masc|Number=Sing	NOUN
mozzarella	NOUN__Gender=Fem|Number=Sing	NOUN
muchines	NOUN__Gender=Fem|Number=Plur	NOUN
muday	ADV___	ADV
muesli	ADJ__Gender=Fem|Number=Plur	ADJ
multivitaminico	ADJ__Gender=Masc|Number=Sing	ADJ
murta	NOUN__Gender=Masc|Number=Sing	NOUN
musli	NOUN__Gender=Fem|Number=Sing	NOUN
naans	VERB__Mood=Ind|Number=Sing|Person=3|Tense=Past|VerbForm=Fin	VERB
nabicol	VERB__Mood=Ind|Number=Sing|Person=3|Tense=Past|VerbForm=Fin	VERB
nabo	NOUN__Gender=Masc|Number=Sing	NOUN
nacho	ADJ__Gender=Masc|Number=Sing|VerbForm=Part	ADJ
nance	NOUN__Gender=Masc|Number=Sing	NOUN
naranja	ADJ__Number=Sing	ADJ
naranjada	NOUN__Gender=Fem|Number=Sing	NOUN
naranjo	NOUN__Gender=Masc|Number=Sing	NOUN
nata	NOUN__Gender=Fem|Number=Sing	NOUN
natilla	NOUN__Gender=Fem|Number=Sing	NOUN
nectar	VERB__VerbForm=Inf	VERB
noquis	VERB__Mood=Ind|Number=Sing|Person=3|Tense=Past|VerbForm=Fin	VERB
nueces	NOUN__Gender=Fem|Number=Plur	NOUN
nuez	NOUN__Gender=Fem|Number=Sing	NOUN
nugget	VERB__Mood=Ind|Number=Sing|Person=3|Tense=Past|VerbForm=Fin	VERB
nutella	VERB__Mood=Ind|Number=Sing|Person=3|Tense=Pres|VerbForm=Fin	VERB
ñame	NOUN__Gender=Masc|Number=Sing	NOUN
oblea	NOUN__Gender=Fem|Number=Sing	NOUN
obwarzanki	VERB__Mood=Ind|Number=Sing|Person=3|Tense=Past|VerbForm=Fin	VERB
odeng	VERB__Mood=Ind|Number=Sing|Person=3|Tense=Past|VerbForm=Fin	VERB
oliebol	NOUN__Gender=Masc|Number=Sing	NOUN
oliva	ADJ__Gender=Fem|Number=Sing	ADJ
oregano	NOUN__Gender=Masc|Number=Sing	NOUN
ossobucco	VERB__Mood=Ind|Number=Sing|Person=3|Tense=Past|VerbForm=Fin	VERB
ostra	NOUN__Gender=Fem|Number=Sing	NOUN
oushe	VERB__Mood=Ind|Number=Sing|Person=3|Tense=Past|VerbForm=Fin	VERB
paella	NOUN__Gender=Fem|Number=Sing	NOUN
pakoda	DET__Gender=Fem|Number=Sing|PronType=Ind	DET
paleta	NOUN__Gender=Fem|Number=Sing	NOUN
palta	ADJ__Number=Sing	ADJ
pambazas	NOUN__Gender=Fem|Number=Plur	NOUN
pamoña	NOUN__Gender=Fem|Number=Sing	NOUN
pan	NOUN__Gender=Masc|Number=Sing	NOUN
panapen	VERB__Mood=Sub|Number=Plur|Person=3|Tense=Pres|VerbForm=Fin	VERB
pancake	ADV___	ADV
panceta	NOUN__Gender=Fem|Number=Sing	NOUN
pandebono	NOUN__Gender=Masc|Number=Sing	NOUN
pandequeso	NOUN__Gender=Masc|Number=Sing	NOUN
pandeyuca	NOUN__Gender=Masc|Number=Sing	NOUN
panecillo	NOUN__Gender=Masc|Number=Sing	NOUN
panela	NOUN__Gender=Fem|Number=Sing	NOUN
panelon	NOUN__Gender=Masc|Number=Sing	NOUN
panes	NOUN__Gender=Masc|Number=Plur	NOUN
panetela	VERB__Mood=Ind|Number=Sing|Person=3|Tense=Pres|VerbForm=Fin	VERB
panini	NOUN__Gender=Masc|Number=Sing	NOUN
panqueque	SCONJ___	SCONJ
papaya	NOUN__Gender=Fem|Number=Sing	NOUN
papilla	NOUN__Gender=Fem|Number=Sing	NOUN
papita	NOUN__Gender=Fem|Number=Sing	NOUN
paprika	NOUN__Gender=Fem|Number=Sing	NOUN
paprikawurst	NOUN__Gender=Masc|Number=Sing	NOUN
parrilla	NOUN__Gender=Fem|Number=Sing	NOUN
pasaboca	VERB__Mood=Ind|Number=Sing|Person=3|Tense=Pres|VerbForm=Fin	VERB
pasta	NOUN__Gender=Fem|Number=Sing	NOUN
pastel	NOUN__Gender=Masc|Number=Sing	NOUN
pastelillo	NOUN__Gender=Masc|Number=Sing	NOUN
pastelito	NOUN__Gender=Masc|Number=Sing	NOUN
pasteurizada	ADJ__Gender=Fem|Number=Sing|VerbForm=Part	ADJ
pastis	ADJ__Number=Sing	ADJ
pastizzi	NOUN__Gender=Masc|Number=Sing	NOUN
patacon	ADP__AdpType=Prep	ADP
patat	NOUN__Gender=Masc|Number=Sing	NOUN
patata	NOUN__Gender=Fem|Number=Sing	NOUN
pate	NOUN___	NOUN
pavo	NOUN__Gender=Masc|Number=Sing	NOUN
paxamadion	NOUN__Gender=Masc|Number=Sing	NOUN
pechuga	NOUN__Gender=Fem|Number=Sing	NOUN
pelanga	VERB__Mood=Sub|Number=Sing|Person=3|Tense=Pres|VerbForm=Fin	VERB
pepinillo	NOUN__Gender=Masc|Number=Sing	NOUN
pepino	NOUN__Gender=Masc|Number=Sing	NOUN
pepsi	ADJ__Number=Sing	ADJ
pera	NOUN__Gender=Fem|Number=Sing	NOUN
perejil	NOUN__Gender=Masc|Number=Sing	NOUN
perignon	NOUN__Gender=Masc|Number=Sing	NOUN
pernil	NOUN__Gender=Masc|Number=Sing	NOUN
pernod	NOUN__Gender=Masc|Number=Sing	NOUN
peroni	NOUN__Gender=Masc|Number=Sing	NOUN
perro	NOUN__Gender=Masc|Number=Sing	NOUN
pescado	NOUN__Gender=Masc|Number=Sing	NOUN
peto	NOUN__Gender=Masc|Number=Sing	NOUN
picada	ADJ__Gender=Fem|Number=Sing|VerbForm=Part	ADJ
picadillo	NOUN__Gender=Masc|Number=Sing	NOUN
picante	ADJ__Number=Sing	ADJ
picnic	NOUN__Gender=Masc|Number=Sing	NOUN
pilsen	VERB__Mood=Sub|Number=Plur|Person=3|Tense=Imp|VerbForm=Fin	VERB
pimenton	NOUN__Gender=Masc|Number=Sing	NOUN
pimienta	NOUN__Gender=Fem|Number=Sing	NOUN
pimiento	NOUN__Gender=Masc|Number=Sing	NOUN
pincho	NOUN__Gender=Masc|Number=Sing	NOUN
piña	NOUN__Gender=Fem|Number=Sing	NOUN
piñita	VERB__Mood=Ind|Number=Sing|Person=3|Tense=Pres|VerbForm=Fin	VERB
pionono	NOUN__Gender=Masc|Number=Sing	NOUN
pipers	NOUN__Gender=Masc|Number=Plur	NOUN
pisco	NOUN__Gender=Masc|Number=Sing	NOUN
pistacho	NOUN__Gender=Masc|Number=Sing	NOUN
pita	VERB__Mood=Ind|Number=Sing|Person=3|Tense=Pres|VerbForm=Fin	VERB
pitahaya	ADJ__Number=Sing	ADJ
pitaya	NOUN__Gender=Fem|Number=Sing	NOUN
pizza	NOUN__Gender=Fem|Number=Sing	NOUN
platano	NOUN__Gender=Masc|Number=Sing	NOUN
platija	NOUN__Gender=Fem|Number=Sing	NOUN
platillo	NOUN__Gender=Masc|Number=Sing	NOUN
pochoclo	NOUN__Gender=Masc|Number=Sing	NOUN
pollo	NOUN__Gender=Masc|Number=Sing	NOUN
pomelo	NOUN__Gender=Masc|Number=Sing	NOUN
ponque	SCONJ___	SCONJ
poroto	NOUN__Gender=Masc|Number=Sing	NOUN
porotta	NOUN__Gender=Masc|Number=Sing	NOUN
porridge	NOUN__Gender=Masc|Number=Sing	NOUN
postre	ADP__AdpType=Prep	ADP
potajes	NOUN__Gender=Masc|Number=Plur	NOUN
pretzel	ADJ__Number=Sing	ADJ
proteina	NOUN__Gender=Fem|Number=Sing	NOUN
pudin	ADV___	ADV
puerro	NOUN__Gender=Masc|Number=Sing	NOUN
pulpa	NOUN__Gender=Fem|Number=Sing	NOUN
pulpo	NOUN__Gender=Masc|Number=Sing	NOUN
pure	NOUN___	NOUN
quesada	ADJ__Gender=Fem|Number=Sing|VerbForm=Part	ADJ
quesadilla	NOUN__Gender=Fem|Number=Sing	NOUN
quesillo	NOUN__Gender=Masc|Number=Sing	NOUN
queso	NOUN__Gender=Masc|Number=Sing	NOUN
quiche	ADJ__Gender=Fem|Number=Sing	ADJ
quinoa	NOUN__Gender=Fem|Number=Sing	NOUN
rabano	NOUN__Gender=Masc|Number=Sing	NOUN
ravioli	NOUN__Gender=Masc|Number=Plur	NOUN
ravioles	ADJ__Number=Plur	ADJ
redbull	VERB__Mood=Ind|Number=Sing|Person=3|Tense=Past|VerbForm=Fin	VERB
refresco	NOUN__Gender=Masc|Number=Sing	NOUN
refrigerio	NOUN__Gender=Masc|Number=Sing	NOUN
refrito	NOUN__Gender=Masc|Number=Sing	NOUN
regaliz	NOUN__Gender=Masc|Number=Sing	NOUN
rellena	VERB__Mood=Ind|Number=Sing|Person=3|Tense=Pres|VerbForm=Fin	VERB
remolacha	NOUN__Gender=Fem|Number=Sing	NOUN
repollo	NOUN__Gender=Masc|Number=Sing	NOUN
requeson	ADJ__Number=Sing	ADJ
requezon	VERB__Mood=Ind|Number=Sing|Person=3|Tense=Past|VerbForm=Fin	VERB
res	NOUN__Gender=Fem|Number=Sing	NOUN
rice	NOUN__Gender=Masc|Number=Sing	NOUN
rollito	NOUN__Gender=Masc|Number=Sing	NOUN
rollo	NOUN__Gender=Masc|Number=Sing	NOUN
romero	NOUN__Gender=Masc|Number=Sing	NOUN
ron	VERB__Mood=Ind|Number=Plur|Person=3|Tense=Past|VerbForm=Fin	VERB
rosbif	NOUN__Gender=Masc|Number=Sing	NOUN
roastbeef	NOUN__Gender=Masc|Number=Sing	NOUN
rosquilla	NOUN__Gender=Fem|Number=Sing	NOUN
rosticcerie	VERB__Mood=Ind|Number=Sing|Person=3|Tense=Past|VerbForm=Fin	VERB
rotisserie	VERB__Mood=Ind|Number=Sing|Person=3|Tense=Past|VerbForm=Fin	VERB
ruibarbo	NOUN__Gender=Masc|Number=Sing	NOUN
sal	NOUN__Gender=Fem|Number=Sing	NOUN
salame	NOUN__Gender=Masc|Number=Sing	NOUN
salami	NOUN__Gender=Masc|Number=Sing	NOUN
salchicha	NOUN__Gender=Fem|Number=Sing	NOUN
salchichon	VERB__Mood=Ind|Number=Sing|Person=3|Tense=Past|VerbForm=Fin	VERB
salchipapa	NOUN___	NOUN
salmon	NOUN__Gender=Masc|Number=Sing	NOUN
salpicon	ADP__AdpType=Prep	ADP
salsa	NOUN__Gender=Fem|Number=Sing	NOUN
salvado	ADJ__Gender=Masc|Number=Sing|VerbForm=Part	ADJ
salvia	NOUN__Gender=Fem|Number=Sing	NOUN
sancocho	NOUN__Gender=Masc|Number=Sing	NOUN
sandia	NOUN___	NOUN
sanduche	NOUN__Gender=Fem|Number=Sing	NOUN
sandwich	ADJ__Number=Sing	ADJ
sardina	NOUN__Gender=Fem|Number=Sing	NOUN
sardinilla	NOUN__Gender=Fem|Number=Sing	NOUN
seagram	VERB__Mood=Ind|Number=Sing|Person=3|Tense=Past|VerbForm=Fin	VERB
's	PROPN___	PROPN
semilla	NOUN__Gender=Fem|Number=Sing	NOUN
semola	NOUN__Gender=Fem|Number=Sing	NOUN
seta	NOUN__Gender=Fem|Number=Sing	NOUN
shiitake	NOUN__Gender=Masc|Number=Sing	NOUN
sidra	NOUN__Gender=Fem|Number=Sing	NOUN
smirnoff	NOUN___	NOUN
snack	ADJ__Number=Sing	ADJ
snickers	NOUN__Gender=Masc|Number=Plur	NOUN
soda	NOUN__Gender=Fem|Number=Sing	NOUN
soja	NOUN__Gender=Fem|Number=Sing	NOUN
sopa	NOUN__Gender=Fem|Number=Sing	NOUN
sorbete	NOUN__Gender=Masc|Number=Sing	NOUN
soya	NOUN__Gender=Fem|Number=Sing	NOUN
spaghetti	ADJ__Number=Sing	ADJ
spaghettis	NOUN__Gender=Masc|Number=Plur	NOUN
sparkling	NOUN___	NOUN
spritzer	VERB__Mood=Ind|Number=Sing|Person=3|Tense=Past|VerbForm=Fin	VERB
steak	NOUN__Gender=Masc|Number=Sing	NOUN
stolichnaya	AUX__Mood=Sub|Number=Sing|Person=3|Tense=Pres|VerbForm=Fin	AUX
sushi	NOUN__Gender=Masc|Number=Sing	NOUN
sushki	VERB__Mood=Ind|Number=Sing|Person=3|Tense=Past|VerbForm=Fin	VERB
sutter	NOUN__Gender=Masc|Number=Sing	NOUN
taco	NOUN__Gender=Masc|Number=Sing	NOUN
taittinger	VERB__VerbForm=Inf	VERB
taiyaki	VERB__Mood=Ind|Number=Sing|Person=3|Tense=Past|VerbForm=Fin	VERB
tallarin	VERB__Mood=Ind|Number=Sing|Person=3|Tense=Past|VerbForm=Fin	VERB
tamal	NOUN__Gender=Masc|Number=Sing	NOUN
tarta	NOUN__Gender=Fem|Number=Sing	NOUN
tartara	VERB__Mood=Sub|Number=Sing|Person=3|Tense=Imp|VerbForm=Fin	VERB
tequila	NOUN__Gender=Masc|Number=Sing	NOUN
ternera	NOUN__Gender=Fem|Number=Sing	NOUN
ternero	NOUN__Gender=Masc|Number=Sing	NOUN
tilapia	NOUN__Gender=Fem|Number=Sing	NOUN
tilsit	NOUN__Gender=Masc|Number=Sing	NOUN
tinto	NOUN__Gender=Masc|Number=Sing	NOUN
tiramisu	NOUN___	NOUN
tisanas	NOUN__Gender=Fem|Number=Plur	NOUN
toblerone	VERB__Mood=Ind|Number=Sing|Person=3|Tense=Pres|VerbForm=Fin	VERB
tocino	NOUN__Gender=Masc|Number=Sing	NOUN
tofu	NOUN__Gender=Masc|Number=Sing	NOUN
tomate	NOUN__Gender=Masc|Number=Sing	NOUN
tomillo	NOUN__Gender=Masc|Number=Sing	NOUN
toronja	NOUN__Gender=Fem|Number=Sing	NOUN
torreja	VERB__Mood=Ind|Number=Sing|Person=3|Tense=Pres|VerbForm=Fin	VERB
torta	NOUN__Gender=Fem|Number=Sing	NOUN
tortilla	NOUN__Gender=Fem|Number=Sing	NOUN
tostada	ADJ__Gender=Fem|Number=Sing|VerbForm=Part	ADJ
tostado	ADJ__Gender=Masc|Number=Sing|VerbForm=Part	ADJ
trago	NOUN__Gender=Masc|Number=Sing	NOUN
trigo	NOUN__Gender=Masc|Number=Sing	NOUN
trucha	NOUN__Gender=Fem|Number=Sing	NOUN
trufa	NOUN__Gender=Fem|Number=Sing	NOUN
tuberculo	ADJ__Gender=Fem|Number=Sing	ADJ
turron	VERB__Mood=Ind|Number=Plur|Person=3|Tense=Past|VerbForm=Fin	VERB
twix	NOUN__Gender=Masc|Number=Sing	NOUN
uva	NOUN__Gender=Fem|Number=Sing	NOUN
vainilla	NOUN__Gender=Fem|Number=Sing	NOUN
vanilla	VERB__Mood=Ind|Number=Sing|Person=3|Tense=Pres|VerbForm=Fin	VERB
vegetal	ADJ__Number=Sing	ADJ
velout	NOUN__Gender=Masc|Number=Sing	NOUN
verdura	NOUN__Gender=Fem|Number=Sing	NOUN
vermouth	NOUN__Gender=Masc|Number=Sing	NOUN
vinagre	ADJ__Gender=Masc|Number=Sing	ADJ
vinagreta	NOUN__Gender=Fem|Number=Sing	NOUN
vino	NOUN__Gender=Masc|Number=Sing	NOUN
vodka	NOUN__Gender=Masc|Number=Sing	NOUN
volovan	VERB__Mood=Ind|Number=Plur|Person=3|Tense=Pres|VerbForm=Fin	VERB
whiskey	NOUN__Gender=Masc|Number=Sing	NOUN
whisky	NOUN__Gender=Masc|Number=Sing	NOUN
willkaparu	VERB__Mood=Ind|Number=Sing|Person=3|Tense=Past|VerbForm=Fin	VERB
yaniqueques	NOUN__Gender=Masc|Number=Plur	NOUN
yeast	ADV___	ADV
yema	NOUN__Gender=Fem|Number=Sing	NOUN
yerbabuena	NOUN__Gender=Fem|Number=Sing	NOUN
yogur	NOUN__Gender=Masc|Number=Sing	NOUN
yogurt	NOUN__Gender=Masc|Number=Sing	NOUN
yuca	NOUN__Gender=Fem|Number=Sing	NOUN
zabaione	VERB__Mood=Ind|Number=Sing|Person=3|Tense=Pres|VerbForm=Fin	VERB
zacapa	VERB__Mood=Ind|Number=Sing|Person=3|Tense=Past|VerbForm=Fin	VERB
zanahoria	NOUN__Gender=Fem|Number=Sing	NOUN
zancarron	VERB__Mood=Ind|Number=Plur|Person=3|Tense=Past|VerbForm=Fin	VERB
zapiekanki	NOUN__Gender=Masc|Number=Sing	NOUN
zarajo	VERB__Mood=Ind|Number=Sing|Person=3|Tense=Past|VerbForm=Fin	VERB
zarangollo	NOUN__Gender=Masc|Number=Sing	NOUN
zarzamora	NOUN__Gender=Fem|Number=Sing	NOUN
zongzi	NOUN__Gender=Masc|Number=Sing	NOUN
zumo	NOUN__Gender=Masc|Number=Sing	NOUN
